111100011100101
M00001110101101
101011000101100
101001010000111
00110001010110G
011000110001001
100011100111111
101110001000000
100000000011111
001001001001001