011100011100001
M00001110101101
101011000101100
101001010000101
00110001010110G
011000110001001
100011100111101
101110001000000
100000000011111
001001001001001