000111111111000
000001000010010
001101011010110
101001011010111
M01111000010001
100011011000101
10100001110010G
101111110110111
000000000010000
000111111111000
